#####
#..E#
###.#
#S..#
#####
